%%%%%%%%%%%%%%%%%%%%
%                  %
%     %%%%      % R% 
%    %%  %%     %  %
%    %    %        %
%   %%    %%    %  %
%   %      %    %  % 
%  %%%%%%% %%   %  %  
%  %        %   %  %  
% %%        %%  %  %  
% %          %  %  % 
%.                 %
%%%%%%%%%%%%%%%%%%%%
