%%%%%%%%%%%%%%%%%%%%%%%%%%%%%%%%%%%%%%
%                                   R%
%     %%%%     %%%       % %       % %
%    %%  %%    %%%%      % %       % %
%    %    %    %  %%     % %       % %
%   %%    %%   %   %%    % %       % %
%   %      %   %    %%   % %       % %
%  %%%%%%%%%%  %     %%  % %       % %
%  %        %  %      %% % %       % %
% %%        %% %       %%% %%     %% %
% %          % %        %%  %%%%%%%  %
%.                                   %
%%%%%%%%%%%%%%%%%%%%%%%%%%%%%%%%%%%%%%
