%%%%%%%%%%%%%%%%%%%%
%.           ..%   %
%.%%.%%.%%.%%.%% % %
%        R       % %
%%%%%%%%%%%%%%%%%% %
%.....             %
%%%%%%%%%%%%%%%%%%%%
