%%%%%%%%%%%%%%%%%%%%%
%                  R%
%     %%%%      %%  %
%    %%  %%     %%  %
%    %    %   .     %
%   %%    %%    %%  %
%          %    %%  %
%  %%%%%%% %%   %%  %
%  %            %%  %
% %%        %%  %%  %
% %          %  %%  %
%                  B%
%%%%%%%%%%%%%%%%%%%%%
