%%%%%%%%%%%%%%%%%%%%%%%%%%%%%%%%%%%%%%
%.            .                     B%
%     %%%%     %%%       % %       % %
%    %%  %%    %%%%      % %       % %
%    %    %    %. %%     % %       % %
%.  %%    %%   %   %%    % %       %.%
%.  %      %   %    %%   % %       %.%
%  %%%%%%%%%%  %     %%  % %       % %
%  %        %  %      %% % %       % %
% %%        %% %       %%% %%    .%% %
% %          % %        %%  %%%%%%%  %
%.            .                     R%
%%%%%%%%%%%%%%%%%%%%%%%%%%%%%%%%%%%%%%
