%%%%%%%%%%%%%%%%%%%%%%%%%%%%%%%%%%%%
%.                                R%
% %%%%%%%%%%%%%%%%%%%%%%% %%%%%%%% %
% %%   %   %     .%%%%%%%   %%.    %
% %% % % % % %%%% %%%%%%%%% %% %%%%%
% %%.% % % %           . %% %%    .%
%.%% % %.% % % %%%%  %%%    %%%%%% %
% %  % % %   %   .%% %%%%%%%%      %
% %% % % %%%%%%%% %%        %% %%%%%
% %% %   %%       %%%%%%%%% %%     %
%B   %%%%%% %%%%%%%      %% %%%%%% %
%%%%%%     .%   .   %%%% %% % .    %
%      %%%%%% %%%%% %    %% %% %%%%%
% %%%%%%      %       %%%%% %%     %
%        %%%%%% %%%%%%%%%%% %%  %% %
%%%%%%%%%%         .        %%%%%% %
%.         %%%%%%%%%%%%%%%%     .  %
%%%%%%%%%%%%%%%%%%%%%%%%%%%%%%%%%%%%
