%%%%%
%.B %
%.  %
%   %
% . %
% . %
% . %
%   %
% R %
%%%%%
