%%%%%
%.B.%
%...%
%...%
%...%
%...%
%...%
%...%
%.R.%
%%%%%
