%%%%%%%%%
%..R...B% 
%.%.%.%%%  
%.....%%% 
%%%%%%%%%
